node,2021
CHE,18000
CHN,14000
DEU,18000
IND,18000
KOR,18000
MYS,18000
ROA,18000
ROE,18000
ROW,18000
THA,18000
USA,18000
VNM,18000
