node,2021
CHE,24000
CHN,24000
DEU,24000
IND,24000
KOR,24000
MYS,24000
ROA,24000
ROE,24000
ROW,24000
THA,24000
USA,24000
VNM,24000
