node,2021
CHE,17000
CHN,17000
DEU,17000
IND,17000
KOR,17000
MYS,17000
ROA,17000
ROE,17000
ROW,17000
THA,17000
USA,17000
VNM,17000
