node,2021
CHE,16000
CHN,16000
DEU,16000
IND,16000
KOR,16000
MYS,16000
ROA,16000
ROE,16000
ROW,16000
THA,16000
USA,16000
VNM,16000
